16 15
  *************
* *          **
*   **** ******
* * *        **
*  *  **** ****
**** ***      *
*       **** **
************  *
*             *
**** * ********
*    *        *
********* ** **
*          *  *
*  ****  ******
*     *        
************** 