10 10
  ********
* *      *
*   **** *
*****    *
*     ****
*** ***  *
*      * *
*****  * *
*        *
********  